──┬─┬─────────┬─────────┬───┬───┬───────────┬─────────────────┬─────┬─────┬─┬─┬─┬─┬───┬───┬───┬─┬─────┬─┬───┬─┬─┬─┬───────────┬─┬─────────┬─┐
# │ │         │         │   │   │           │                 │     │     │ │ │ │ │   │   │   │ │     │ │   │ │ │ │           │ │         │ │
│ │ │ │ ──┐ ──┴── ──┐ ──┼── └── │ ──────┬───┘ ────────┐ ┌───┬─┼── ──┴─┐ ┌─┘ │ │ │ │ ┌─┼── │ ──┤ │ ┌─┐ │ │ ┌─┘ │ │ │ │ ──┬─┐ ──┘ └──── ──┬─┘ │
│     │   │         │   │       │       │             │ │   │ │       │ │   │       │ │       │   │ │ │   │   │     │   │ │             │   │
│ │ ──┴───┤ │ │ │ │ │ ──┘ ┌── │ │ │ │ ┌─┤ ────┐ │ │ ┌─┼─┴─┐ │ │ ┌─┬─┬─┤ └── │ ──────┤ ├── ────┴─┐ │ └─┘ ┌─┤ ──┘ ────┴───┘ └───┐ ──┬─┬─┬─┘ ──┤
│ │       │ │ │ │ │ │     │   │ │ │ │ │ │     │ │ │ │ │   │   │ │ │ │ │             │ │         │       │ │                   │   │ │ │     │
│ └───┬─┬─┼─┘ └─┴─┴─┤ ──┬─┤ ┌─┼─┘ └─┴─┘ │ ──┬─┴─┼─┴─┤ │ ┌─┘ ┌─┘ │ │ │ │ ────────┬───┤ └── │ ┌─┐ │ ──┬───┘ │ ──┐ ┌── ──────┐ ──┼─┬─┘ │ │ ┌───┤
│     │ │ │         │   │ │ │ │             │   │   │   │   │                   │   │     │ │ │ │   │         │ │         │   │ │       │   │
│ │ ┌─┘ │ ├── │ │ ──┴─┐ │ └─┘ │ ┌─┐ ──┐ ────┘ ──┘ ┌─┘ │ │ │ └─┐ ──┐ ┌───────┐ │ │ ──┘ ──┐ └─┘ └─┘ ──┘ ┌───┐ │ │ ├───┐ ┌─┬─┼─┬─┘ │ ┌── │ │ │ │
│ │ │     │   │ │     │         │ │   │           │   │   │   │   │ │       │ │         │             │   │ │ │ │   │ │ │ │ │   │ │   │ │ │ │
│ │ │ ┌── ├─┐ └─┤ │ ┌─┘ ──────┬─┘ │ ──┼───┬─┐ │ │ └───┤ ──┼─┬─┘ │ ├─┤ ──┬───┼─┘ ──┬───┬─┘ ┌─┐ │ │ ┌─┬─┼── └─┼─┼─┴── └─┘ │ │ └── ├─┤ ──┼─┘ ├─┤
│ │   │   │ │   │ │ │         │   │   │   │ │ │ │     │   │ │   │ │ │   │   │     │   │   │ │ │ │ │ │ │     │ │         │       │ │   │   │ │
│ └───┴───┤ │ ──┴─┴─┴─┬─┐ ┌─┬─┘ ──┼─┬─┤ ──┤ ├─┴─┼── ┌─┘ ┌─┘ │ ──┼─┘ │ ┌─┘ ──┼───┬─┘ ┌─┴───┤ │ └─┤ │ │ └── ──┘ └──── ┌───┘ │ ──┬─┤ │ ┌─┼─┐ │ │
│         │           │ │ │ │     │ │ │   │ │   │   │   │       │   │ │     │   │   │     │     │                   │     │   │ │   │ │ │   │
│ ┌─┐ │ ┌─┴── ──┐ │ ──┘ └─┤ │ ────┘ │ │ │ │ ├─┐ └───┼─┐ ├──── ──┘ ──┘ │ ────┴── │ │ │ ────┼───┐ │ │ ┌─┐ ──┐ ──┐ ┌── │ ──┐ └───┘ │ │ │ │ │ │ │
│ │ │ │ │       │ │       │             │ │ │ │     │ │ │                       │ │       │   │ │ │ │ │   │   │ │       │         │       │ │
│ │ ├─┼─┤ │ │ │ │ │ ──┐ │ │ │ │ │ ────┬─┼─┘ │ │ ────┘ │ │ ┌─┐ ┌─┬─┬─────────────┘ └───────┤ ──┴─┤ │ │ └─┬─┴─┬─┤ ├── ────┤ │ ──┐ │ ├─┐ ──┬─┤ │
│   │ │ │ │ │ │ │ │   │ │   │ │ │     │ │             │ │ │ │ │ │ │                       │     │ │     │   │ │ │       │ │   │ │ │ │   │ │ │
│ ┌─┘ │ ├─┤ ├─┤ ├─┼─┬─┤ ├── └─┴─┼── ──┘ │ │ │ │ ──┬─┬─┘ └─┤ │ │ │ │ ──┐ ┌─┐ │ ┌───┐ ──────┘ ──┬─┼─┤ │ ──┘ ──┤ │ │ ┌── ──┼─┼───┤ └─┘ ├── │ └─┤
│ │   │ │ │ │ │ │ │ │ │ │       │         │ │ │   │ │     │ │   │     │ │ │ │ │   │           │ │ │ │       │ │ │ │     │ │   │     │       │
│ └── │ │ └─┘ ├─┤ │ │ └─┴─┬─┐ │ │ │ ┌── ──┴─┴─┼── │ └── ──┤ │ ──┤ ────┤ │ ├─┘ │ ──┤ │ ──┐ ──┐ │ │ │ │ │ │ │ │ └─┼─┼─┬───┤ │ ──┴─┐ ──┤ ┌─┐ │ │
│       │     │ │         │ │ │ │ │ │         │           │ │   │     │   │       │ │   │   │     │ │ │ │ │     │ │ │   │       │   │ │ │ │ │
│ │ ──┐ │ ────┘ └── │ │ ──┘ └─┤ │ │ │ │ │ ────┤ │ │ │ │ ──┘ └── │ ┌── │ │ │ ──┐ │ └─┴───┴───┤ │ ──┴─┤ │ ├─┘ │ │ │ │ │ ──┘ ──┐ ──┤ │ │ │ │ │ │
│ │   │             │ │       │ │ │ │ │ │     │ │ │ │ │           │   │ │ │   │ │           │ │     │ │ │   │ │             │   │ │ │   │ │ #
└─┴───┴─────────────┴─┴───────┴─┴─┴─┴─┴─┴─────┴─┴─┴─┴─┴───────────┴───┴─┴─┴───┴─┴───────────┴─┴─────┴─┴─┴───┴─┴─────────────┴───┴─┴─┴───┴─┴──
